
.........................................................
.........................................................
....#######.....#####......########......................
....#.............#........#..#...#......................
....#.............#...........#..........................
....####..........#...........#..........................
....#.............#...........#..........................
....#...........#####.........#..........................
.........................................................
.........................................................
.........................................................
.........................................................
.........................................................
