
................................................................................
......#######################....#.....##########...............................
.................................#....................#...........#.............
.................................#.....................#.........#..............
..........########################......................#.......#...............
.................................#......#########........#.....#................
.................................#......#.......#.........#...#.................
..########################.......#......#.......#..........#.#..................
..#.....................................#.......#...........#...................
..#.....................................#.......#...........#########...........
..#..............########################.......#...#.......#...................
..#.................................................#.......#...................
..#.................................................#.......#...................
..#.............................................................................
............................................................#........#..........
........#######################################.............#........#..........
............................................................#........#..........
................................................................................
